MapsAmount=1
Width=21
Height=9

#####################
#            UT     #
#            #      #
## #  GGG   G#      #
#     MMM S  ########
#     KKK      #    #
#####          U    #
#C  HT         #    #
#####################
