MapsAmount=1
Width=21
Height=9

#####################
#            UT     #
#            #      #
## #        G#      #
#         S  ########
#              #    #
#####          U    #
#C  HT         #    #
#####################
