MapsAmount=3
Width=10
Height=6

##########
#        U
#      T #
## #   ###
#K MG   S#
##########

##########
#        #
#        #
#        #
#       S#
##########

##########
U     ####
# T   T ##
# T   #H##
####### ##
##########
